02 02 02 02 02 02 02 02 02 02 02 02 02 02 02 02 02 02 02 02 02 02 02 02 02 02 02 02 02 02 02 02 02 02 02 02 02 02 02 02 02 02 02 02 02 02 02 02 02 02
02 02 02 02 02 02 02 02 02 02 02 02 02 02 03 02 02 02 02 02 02 02 02 02 02 02 02 02 02 02 02 02 02 02 02 02 02 02 02 02 02 02 02 02 02 02 02 02 02 02
02 02 02 02 02 02 02 03 02 02 02 02 02 02 02 02 02 02 02 02 02 02 02 02 02 03 02 02 02 02 02 02 02 03 02 02 02 02 02 02 02 02 02 02 02 02 02 02 02 02
02 02 02 02 03 02 02 02 02 02 02 03 02 02 02 02 02 02 03 02 02 02 02 02 02 02 02 03 02 02 02 02 02 02 02 02 02 02 02 02 02 03 02 02 02 02 02 02 02 02
02 02 02 02 02 02 02 02 02 03 02 02 02 02 02 03 02 02 02 02 02 02 02 03 02 02 02 02 02 02 02 03 02 02 03 02 02 02 03 02 02 02 02 02 02 02 02 02 02 02
02 02 02 02 02 02 02 02 02 02 02 02 02 02 02 02 02 02 02 02 02 03 02 02 02 02 02 02 02 03 02 02 02 02 02 02 03 02 02 02 02 02 02 03 02 02 02 02 02 02
02 02 02 02 02 03 12 10 10 10 10 10 10 10 13 02 02 02 12 10 10 10 10 10 10 10 10 13 02 02 02 12 10 10 10 10 10 10 10 10 10 10 13 02 02 02 02 02 02 02
02 02 02 02 02 02 08 31 30 30 30 30 30 31 09 10 10 10 11 31 00 00 01 00 00 00 00 09 10 10 10 11 31 00 25 23 23 23 23 23 23 26 07 02 02 03 02 02 02 02
02 02 03 02 02 02 08 31 30 29 29 29 30 31 31 31 31 31 31 31 00 04 05 05 05 06 00 31 31 31 31 31 31 31 21 16 16 16 16 16 16 20 07 02 02 02 02 02 02 02
02 02 02 02 02 02 08 31 30 29 29 29 30 31 31 31 31 31 31 31 00 07 02 02 02 08 00 31 31 31 31 31 31 31 21 16 16 16 16 16 16 20 07 02 02 02 02 02 02 02
02 02 02 03 02 02 08 31 30 29 29 29 30 31 31 31 31 31 31 31 00 07 02 02 02 08 01 31 31 31 31 31 31 31 21 16 16 16 16 16 16 20 07 02 03 02 02 02 02 02
02 02 02 02 03 02 08 31 30 29 29 29 30 31 31 31 31 31 31 31 00 09 10 10 10 11 00 31 31 31 31 31 31 31 21 16 16 16 16 16 16 20 07 02 02 02 02 02 02 02
02 02 02 02 02 02 08 31 30 30 29 30 30 31 31 31 31 31 31 31 01 00 25 23 26 00 00 31 31 31 31 31 31 31 27 18 18 19 16 17 18 28 07 03 02 02 02 02 02 02
02 02 02 02 02 02 08 31 31 31 00 31 31 31 31 31 31 31 31 31 31 31 21 16 20 31 31 31 31 31 31 31 31 31 31 31 31 21 16 20 04 05 15 02 02 02 02 02 02 02
02 02 02 02 03 02 08 31 31 31 00 31 31 31 31 31 31 31 31 31 31 31 21 16 20 31 31 31 31 31 31 31 31 31 31 31 31 21 16 20 07 02 02 02 02 03 02 02 02 02
02 02 02 02 02 02 14 05 06 31 00 31 31 31 31 31 31 31 31 31 31 31 21 16 20 31 31 31 31 31 31 31 31 31 31 31 31 21 16 20 07 02 02 02 02 02 02 02 02 02
02 02 02 02 02 02 02 02 08 31 00 31 31 31 31 31 31 31 31 31 31 31 21 16 20 31 31 31 31 31 31 31 31 31 31 31 31 21 16 20 07 02 02 02 02 02 03 02 02 02
02 02 03 02 02 02 02 12 11 31 00 31 31 31 31 31 31 31 31 31 31 31 21 16 20 31 31 31 31 31 31 31 31 31 31 25 23 24 16 20 07 02 02 03 02 02 02 02 02 02
02 02 02 02 02 02 02 08 00 00 00 31 31 31 31 31 31 31 31 31 31 31 21 16 20 31 31 31 31 31 31 31 31 31 31 21 16 16 16 20 07 02 02 02 02 02 02 02 02 02
02 02 02 03 02 02 02 08 00 31 31 31 31 31 31 31 31 31 31 31 31 00 21 16 20 00 31 31 31 31 31 31 31 31 31 21 16 17 18 28 07 02 03 02 02 02 02 02 02 02
02 02 02 02 02 02 02 08 00 31 31 31 00 25 23 23 23 23 23 23 23 23 24 16 22 23 23 23 23 23 23 23 23 23 23 24 16 20 00 31 07 02 02 02 02 02 02 02 02 02
02 02 02 02 02 03 02 08 00 31 31 31 01 21 16 16 16 16 16 16 16 16 16 16 16 16 16 16 16 16 16 16 16 16 16 16 16 20 00 04 15 02 02 02 02 02 02 02 02 02
02 02 02 02 02 02 03 08 00 00 31 31 00 27 18 18 18 18 18 18 18 18 19 16 17 18 18 18 18 18 18 18 18 18 18 19 16 20 00 07 02 03 02 02 02 02 02 02 02 02
02 02 02 02 02 02 02 14 06 00 31 31 00 31 31 31 31 31 31 31 31 00 21 16 20 00 31 31 31 31 31 31 31 31 31 21 16 20 00 07 02 02 02 02 03 02 02 02 02 02
02 02 02 02 02 02 02 02 08 00 31 31 00 31 31 31 31 31 31 31 31 31 21 16 20 31 31 31 31 31 31 31 31 31 31 21 16 20 01 07 02 02 02 02 02 02 02 02 02 02
02 02 02 02 02 03 02 12 11 00 31 31 00 00 00 31 31 31 31 31 31 31 21 16 20 31 31 31 31 31 31 31 31 31 31 21 16 20 00 07 02 02 02 03 02 02 02 02 02 02
02 02 02 02 02 02 02 08 00 00 31 31 31 31 00 31 31 31 31 31 31 31 21 16 20 31 31 31 31 31 31 31 31 31 31 21 16 20 00 07 02 02 02 02 02 02 02 02 02 02
02 02 02 03 02 02 02 08 00 31 31 31 31 31 00 31 31 31 31 31 31 31 21 16 20 31 31 00 31 31 31 31 31 31 31 21 16 20 00 07 02 03 02 02 02 02 02 02 02 02
02 02 02 02 02 02 02 08 00 31 31 31 31 31 00 31 31 31 31 31 31 31 21 16 20 31 31 31 31 31 00 31 31 31 31 21 16 20 00 07 02 02 02 02 02 02 02 02 02 02
02 02 02 02 02 02 03 08 00 00 00 00 00 00 00 31 31 31 31 31 31 31 21 16 20 31 31 31 31 31 00 31 31 31 31 27 18 28 00 07 02 02 02 02 03 02 02 02 02 02
02 02 02 02 02 02 02 08 00 00 01 00 00 00 00 31 31 31 31 31 31 31 21 16 20 31 31 31 31 31 31 31 31 31 31 31 00 31 04 15 02 02 03 02 02 02 02 02 02 02
02 02 02 02 02 02 02 14 06 00 00 00 00 00 00 31 31 31 31 31 31 31 21 16 20 31 31 31 31 31 31 31 31 31 31 00 00 00 07 02 02 02 02 02 02 02 02 02 02 02
02 02 02 02 02 03 02 02 08 00 00 00 00 01 00 31 31 31 31 31 31 31 21 16 20 31 31 31 31 31 31 31 31 31 31 00 00 00 07 02 02 02 02 02 02 02 03 02 02 02
02 02 02 02 02 02 02 02 08 01 00 00 00 00 00 31 31 31 31 31 31 31 21 16 20 31 31 31 31 31 31 31 31 31 31 00 00 01 07 02 02 03 02 02 02 02 02 02 02 02
02 02 02 02 02 02 02 02 08 00 00 00 00 00 00 31 31 31 31 31 31 31 21 16 20 31 31 31 31 31 31 31 31 31 31 00 00 00 07 02 02 02 02 02 02 02 02 02 02 02
02 02 02 02 03 02 02 12 11 31 31 31 31 31 31 31 31 31 31 31 31 31 27 18 28 31 31 31 31 31 31 31 31 31 31 01 00 00 09 13 02 02 02 02 02 02 02 02 02 02
02 02 02 02 02 02 02 08 31 31 31 31 31 31 31 31 31 31 31 00 00 00 00 00 00 00 00 31 31 31 31 31 31 31 00 00 00 00 00 09 13 02 02 02 03 02 02 02 02 02
02 02 02 02 02 02 03 08 31 31 31 31 31 31 31 31 31 31 00 00 00 00 00 00 00 00 00 00 31 31 00 31 31 00 00 00 00 00 00 00 07 02 02 02 02 02 02 02 02 02
02 02 02 02 02 02 02 08 00 31 31 31 31 31 31 31 31 31 00 01 00 00 00 00 00 01 00 00 31 31 31 31 00 00 00 00 00 01 00 00 07 02 03 02 02 02 02 02 02 02
02 02 02 02 02 02 02 08 00 31 31 31 31 00 31 31 31 31 00 00 01 00 00 00 00 00 00 00 00 31 31 31 00 00 00 00 00 31 00 00 07 02 02 02 02 02 02 02 02 02
02 02 03 02 02 02 02 08 00 31 31 31 31 31 31 31 31 31 00 00 00 00 00 00 00 00 00 00 00 00 00 00 00 00 31 00 00 00 00 00 07 02 02 02 02 03 02 02 02 02
02 02 02 02 02 02 02 08 00 31 31 31 31 00 31 04 05 05 06 00 00 00 00 00 01 00 00 04 05 05 06 00 00 00 00 00 00 00 01 00 07 02 02 02 02 02 02 03 02 02
02 02 02 02 02 02 02 08 31 31 31 31 31 31 04 15 02 02 14 06 00 00 00 00 00 00 04 15 02 02 08 00 00 31 00 00 31 00 00 00 07 02 02 02 02 02 02 02 02 02
02 02 02 02 03 02 02 14 05 05 05 05 05 05 15 02 02 02 02 14 05 05 05 05 05 05 15 02 03 02 14 06 00 01 00 00 00 00 04 05 15 02 03 02 02 02 02 02 02 02
02 02 02 02 02 02 02 02 02 02 02 02 02 02 02 02 02 02 03 02 02 02 02 02 02 02 02 02 02 02 02 14 05 05 05 05 05 05 15 02 02 02 02 02 02 02 03 02 02 02
02 02 02 02 02 02 02 02 02 02 02 03 02 02 02 02 03 02 02 02 02 02 02 02 02 02 02 02 02 02 02 02 02 02 02 02 03 02 02 02 02 02 02 03 02 02 02 02 02 02
02 02 02 02 02 02 03 02 02 02 02 02 02 02 02 02 02 02 02 02 02 02 02 02 03 02 02 02 02 03 02 02 02 02 02 02 02 02 02 02 02 02 02 02 02 02 02 02 02 02
02 02 02 02 02 02 02 02 02 02 02 02 02 02 03 02 02 02 02 02 03 02 02 02 02 02 02 02 02 02 02 02 03 02 02 02 02 02 02 03 02 02 02 02 02 02 02 02 02 02
02 02 02 02 02 02 02 02 02 02 02 02 02 02 02 02 02 02 02 02 02 02 02 02 02 02 02 03 02 02 02 02 02 02 02 02 02 02 02 02 02 02 02 02 02 03 02 02 02 02
02 02 02 02 02 02 02 02 02 02 02 02 02 02 02 02 02 02 02 02 02 02 02 02 02 02 02 02 02 02 02 02 02 02 02 02 02 02 02 02 02 02 02 02 02 02 02 02 02 02
